11111111111111111111111111111111
1..............................1
1........TTTTTTTTTTTTTTT.......1
1........1.............1.......1
1........1.TTTTTTTTTTT.1.......1
1........1.......T.....1.......1
1........1111111.T.11111.......1
1..............1.T.1...........1
1..............1.T.1...........1
1..............1.T.1...........1
1111T11111111111.T.1111111111111
1E.............1.T............S1
1111T1111.111111.T11111111111111
1.......1........T.............1
1.......1TTTTTTTTT.............1
1..............................1
1..............................1
1..............................1
1..............................1
1..............................1
1..............................1
1..............................1
1..............................1
11111111111111111111111111111111
