11111111111111111111111111111111
1...........11111111...........1
1..........11.......1..........1
1..........11.11111.1..........1
1.........111.11111.11.........1
1.........111.1TT11.11.........1
1........11...1..11.111........1
1........11.111..11.1111.......1
1.......111.11TTTT1....1.......1
1.......111.11....1111.11......1
1......1111.1......111.11......1
1......1....1......111.11......1
1.....11.111........11.111.....1
1.....11.11TTTTTTTTTT1.111.....1
1....111.11TTTTTTTTTT1...11....1
1....111.11..........111.11....1
1...1....1............11.111...1
1...1.111.............11.111...1
1..11E1111..........1111...S1..1
1..11111111111111111111111111..1
1..............................1
1..............................1
1..............................1
11111111111111111111111111111111