000000000000000000000000000000
000000000000000000000000000000
000000000000000000000000000000
000000000000000000000000000000
000000000000000000000000000000
000000000000000000000000000000
000000000000000000000000000000
000000000000000000000000000000
000000000000000000000000000000
000000000000000000000000000000
000000011111111000000000000000
000000010000001011111111110000
000000011111101010000000010000
000000000000101010011111110000
002111101110101010010000000000
000000101010101010010111130000
000000101010101010010100000000
000000101010101010010100000000
000000101010101010010100000000
000000101011101010010111110000
000000101000001010010000010000
000000101111101010010000010000
000000100000101110011111110000
000000111111100000000000000000
000000000000000000000000000000
000000000000000000000000000000
000000000000000000000000000000
000000000000000000000000000000
000000000000000000000000000000
000000000000000000000000000000