11111111111111111111111111111111111111111111111111111111111111111111111111
1.........1S1............................................................1
1.........1.1............................................................1
1.........1.1............................................................1
1.........1.1............................................................1
1.........1.1............................................................1
1.........1.1............................................................1
1.........1.1............................................................1
1.........T.1............................................................1
1.........1.1............................................................1
1.........T.1............................................................1
1.........1.1............................................................1
1.........T.1............................................................1
1.........1.1............................................................1
1.........T.1............................................................1
1.........1.1............................................................1
1.........1.1............................................................1
1.........1.1............................................................1
1.........1.1............................................................1
1.........1.1............................................................1
1.........1.1............................................................1
1.........1.1............................................................1
1.........1.1............................................................1
1.........1.1............................................................1
1.........1E1............................................................1
1........................................................................1
1........................................................................1
1........................................................................1
1........................................................................1
1........................................................................1
1........................................................................1
1........................................................................1
1........................................................................1
1........................................................................1
1........................................................................1
1........................................................................1
1........................................................................1
1........................................................................1
1........................................................................1
1........................................................................1
1........................................................................1
1........................................................................1
1........................................................................1
1........................................................................1
1........................................................................1
1........................................................................1
1........................................................................1
1........................................................................1
1........................................................................1
11111111111111111111111111111111111111111111111111111111111111111111111111